date,totalPL,balance,totalPLcumsum,pct_change,day
01-01-19,0,100000,0,,Tuesday
02-01-19,0,100000,0,0,Wednesday
03-01-19,0,100000,0,0,Thursday
04-01-19,0,100000,0,0,Friday
07-01-19,0,100000,0,0,Monday
08-01-19,0,100000,0,0,Tuesday
09-01-19,0,100000,0,0,Wednesday
10-01-19,0,100000,0,0,Thursday
11-01-19,0,100000,0,0,Friday
14-01-19,0,100000,0,0,Monday
15-01-19,0,100000,0,0,Tuesday
16-01-19,0,100000,0,0,Wednesday
17-01-19,0,100000,0,0,Thursday
18-01-19,0,100000,0,0,Friday
21-01-19,0,100000,0,0,Monday
22-01-19,0,100000,0,0,Tuesday
23-01-19,0,100000,0,0,Wednesday
24-01-19,0,100000,0,0,Thursday
25-01-19,-305,99695,-305,-0.00305,Friday
28-01-19,677.5,100372.5,372.5,0.006795727,Monday
29-01-19,62.5,100435,435,0.000622681,Tuesday
30-01-19,1160,101595,1595,0.011549759,Wednesday
31-01-19,5145,106740,6740,0.050642256,Thursday
01-02-19,0,106740,6740,0,Friday
04-02-19,0,106740,6740,0,Monday
05-02-19,0,106740,6740,0,Tuesday
06-02-19,0,106740,6740,0,Wednesday
07-02-19,0,106740,6740,0,Thursday
08-02-19,0,106740,6740,0,Friday
11-02-19,592.5,107332.5,7332.5,0.005550871,Monday
12-02-19,1312.5,108645,8645,0.012228356,Tuesday
13-02-19,2292.5,110937.5,10937.5,0.021100833,Wednesday
14-02-19,2217.5,113155,13155,0.019988732,Thursday
15-02-19,550,113705,13705,0.004860589,Friday
18-02-19,670,114375,14375,0.005892441,Monday
19-02-19,1937.5,116312.5,16312.5,0.016939891,Tuesday
20-02-19,1325,117637.5,17637.5,0.011391725,Wednesday
21-02-19,667.5,118305,18305,0.005674211,Thursday
22-02-19,425,118730,18730,0.003592409,Friday
25-02-19,1867.5,120597.5,20597.5,0.015728965,Monday
26-02-19,-312.5,120285,20285,-0.002591264,Tuesday
27-02-19,-687.5,119597.5,19597.5,-0.005715592,Wednesday
28-02-19,2482.5,122080,22080,0.020757123,Thursday
01-03-19,880,122960,22960,0.007208388,Friday
05-03-19,3492.5,126452.5,26452.5,0.028403546,Tuesday
06-03-19,950,127402.5,27402.5,0.007512702,Wednesday
07-03-19,982.5,128385,28385,0.00771178,Thursday
08-03-19,352.5,128737.5,28737.5,0.002745648,Friday
11-03-19,-212.5,128525,28525,-0.001650646,Monday
12-03-19,-227.5,128297.5,28297.5,-0.001770084,Tuesday
13-03-19,642.5,128940,28940,0.005007892,Wednesday
14-03-19,1635,130575,30575,0.012680316,Thursday
15-03-19,305,130880,30880,0.002335822,Friday
18-03-19,1370,132250,32250,0.010467604,Monday
19-03-19,1205,133455,33455,0.009111531,Tuesday
20-03-19,895,134350,34350,0.00670638,Wednesday
22-03-19,2810,137160,37160,0.020915519,Friday
25-03-19,892.5,138052.5,38052.5,0.006506999,Monday
26-03-19,2555,140607.5,40607.5,0.018507452,Tuesday
27-03-19,100,140707.5,40707.5,0.0007112,Wednesday
28-03-19,440,141147.5,41147.5,0.003127054,Thursday
29-03-19,-437.5,140710,40710,-0.003099594,Friday
01-04-19,-1510,139200,39200,-0.010731291,Monday
02-04-19,487.5,139687.5,39687.5,0.003502155,Tuesday
03-04-19,1115,140802.5,40802.5,0.007982103,Wednesday
04-04-19,-257.5,140545,40545,-0.001828803,Thursday
05-04-19,717.5,141262.5,41262.5,0.005105126,Friday
08-04-19,-1427.5,139835,39835,-0.0101053,Monday
09-04-19,790,140625,40625,0.005649516,Tuesday
10-04-19,730,141355,41355,0.005191111,Wednesday
11-04-19,37.5,141392.5,41392.5,0.00026529,Thursday
12-04-19,342.5,141735,41735,0.002422335,Friday
15-04-19,365,142100,42100,0.002575228,Monday
16-04-19,-130,141970,41970,-0.000914849,Tuesday
18-04-19,125,142095,42095,0.000880468,Thursday
22-04-19,560,142655,42655,0.003941025,Monday
23-04-19,-2.5,142652.5,42652.5,-1.75E-05,Tuesday
24-04-19,-2825,139827.5,39827.5,-0.019803368,Wednesday
25-04-19,-2810,137017.5,37017.5,-0.02009619,Thursday
26-04-19,-62.5,136955,36955,-0.000456146,Friday
30-04-19,797.5,137752.5,37752.5,0.005823081,Tuesday
02-05-19,-2242.5,135510,35510,-0.016279196,Thursday
03-05-19,645,136155,36155,0.004759796,Friday
06-05-19,160,136315,36315,0.001175131,Monday
07-05-19,2992.5,139307.5,39307.5,0.02195283,Tuesday
08-05-19,-180,139127.5,39127.5,-0.001292106,Wednesday
09-05-19,2220,141347.5,41347.5,0.015956587,Thursday
10-05-19,52.5,141400,41400,0.000371425,Friday
13-05-19,4160,145560,45560,0.029420085,Monday
14-05-19,102.5,145662.5,45662.5,0.000704177,Tuesday
15-05-19,-142.5,145520,45520,-0.000978289,Wednesday
16-05-19,412.5,145932.5,45932.5,0.002834662,Thursday
17-05-19,-420,145512.5,45512.5,-0.002878043,Friday
20-05-19,1780,147292.5,47292.5,0.012232626,Monday
21-05-19,-590,146702.5,46702.5,-0.004005635,Tuesday
22-05-19,12.5,146715,46715,8.52E-05,Wednesday
23-05-19,1737.5,148452.5,48452.5,0.011842688,Thursday
24-05-19,-1680,146772.5,46772.5,-0.011316751,Friday
27-05-19,195,146967.5,46967.5,0.001328587,Monday
28-05-19,642.5,147610,47610,0.004371715,Tuesday
29-05-19,930,148540,48540,0.006300386,Wednesday
30-05-19,582.5,149122.5,49122.5,0.003921503,Thursday
31-05-19,-2410,146712.5,46712.5,-0.01616121,Friday
03-06-19,1895,148607.5,48607.5,0.012916418,Monday
04-06-19,1670,150277.5,50277.5,0.011237656,Tuesday
06-06-19,-2570,147707.5,47707.5,-0.017101695,Thursday
07-06-19,80,147787.5,47787.5,0.000541611,Friday
10-06-19,222.5,148010,48010,0.00150554,Monday
11-06-19,22.5,148032.5,48032.5,0.000152017,Tuesday
12-06-19,842.5,148875,48875,0.005691318,Wednesday
13-06-19,-2677.5,146197.5,46197.5,-0.017984887,Thursday
14-06-19,1425,147622.5,47622.5,0.009747089,Friday
17-06-19,-362.5,147260,47260,-0.002455588,Monday
18-06-19,-2442.5,144817.5,44817.5,-0.01658631,Tuesday
19-06-19,-3007.5,141810,41810,-0.020767518,Wednesday
20-06-19,880,142690,42690,0.006205486,Thursday
21-06-19,640,143330,43330,0.004485248,Friday
24-06-19,97.5,143427.5,43427.5,0.000680248,Monday
25-06-19,-1072.5,142355,42355,-0.007477646,Tuesday
26-06-19,1485,143840,43840,0.010431667,Wednesday
27-06-19,2205,146045,46045,0.015329533,Thursday
28-06-19,370,146415,46415,0.002533466,Friday
01-07-19,565,146980,46980,0.003858894,Monday
02-07-19,1342.5,148322.5,48322.5,0.009133896,Tuesday
03-07-19,-270,148052.5,48052.5,-0.001820358,Wednesday
04-07-19,1690,149742.5,49742.5,0.01141487,Thursday
05-07-19,5962.5,155705,55705,0.039818355,Friday
08-07-19,-3030,152675,52675,-0.019459876,Monday
09-07-19,845,153520,53520,0.005534632,Tuesday
10-07-19,-1542.5,151977.5,51977.5,-0.010047551,Wednesday
11-07-19,785,152762.5,52762.5,0.005165238,Thursday
12-07-19,-840,151922.5,51922.5,-0.005498732,Friday
15-07-19,-585,151337.5,51337.5,-0.003850648,Monday
16-07-19,842.5,152180,52180,0.005567027,Tuesday
17-07-19,692.5,152872.5,52872.5,0.004550532,Wednesday
18-07-19,-442.5,152430,52430,-0.002894569,Thursday
19-07-19,5070,157500,57500,0.033261169,Friday
22-07-19,-2410,155090,55090,-0.015301587,Monday
23-07-19,-1527.5,153562.5,53562.5,-0.00984912,Tuesday
24-07-19,880,154442.5,54442.5,0.005730566,Wednesday
25-07-19,-2832.5,151610,51610,-0.018340159,Thursday
26-07-19,807.5,152417.5,52417.5,0.005326166,Friday
29-07-19,970,153387.5,53387.5,0.006364099,Monday
30-07-19,1537.5,154925,54925,0.010023633,Tuesday
31-07-19,272.5,155197.5,55197.5,0.001758916,Wednesday
01-08-19,3602.5,158800,58800,0.023212358,Thursday
02-08-19,-1892.5,156907.5,56907.5,-0.011917506,Friday
05-08-19,297.5,157205,57205,0.001896022,Monday
06-08-19,727.5,157932.5,57932.5,0.004627715,Tuesday
07-08-19,292.5,158225,58225,0.001852057,Wednesday
08-08-19,-2565,155660,55660,-0.016211092,Thursday
09-08-19,575,156235,56235,0.003693948,Friday
13-08-19,2625,158860,58860,0.016801613,Tuesday
14-08-19,-100,158760,58760,-0.000629485,Wednesday
16-08-19,-612.5,158147.5,58147.5,-0.003858025,Friday
19-08-19,297.5,158445,58445,0.001881155,Monday
20-08-19,-582.5,157862.5,57862.5,-0.003676355,Tuesday
21-08-19,3332.5,161195,61195,0.021110143,Wednesday
22-08-19,-2227.5,158967.5,58967.5,-0.013818667,Thursday
23-08-19,-3130,155837.5,55837.5,-0.019689559,Friday
26-08-19,-357.5,155480,55480,-0.002294056,Monday
27-08-19,677.5,156157.5,56157.5,0.004357474,Tuesday
28-08-19,687.5,156845,56845,0.004402606,Wednesday
29-08-19,85,156930,56930,0.000541936,Thursday
30-08-19,-1930,155000,55000,-0.012298477,Friday
03-09-19,3525,158525,58525,0.022741935,Tuesday
04-09-19,810,159335,59335,0.005109604,Wednesday
05-09-19,2892.5,162227.5,62227.5,0.018153576,Thursday
06-09-19,2237.5,164465,64465,0.013792359,Friday
09-09-19,-350,164115,64115,-0.002128112,Monday
11-09-19,995,165110,65110,0.006062822,Wednesday
12-09-19,-2687.5,162422.5,62422.5,-0.016277027,Thursday
13-09-19,-2137.5,160285,60285,-0.013160123,Friday
16-09-19,625,160910,60910,0.003899304,Monday
17-09-19,6127.5,167037.5,67037.5,0.038080293,Tuesday
18-09-19,867.5,167905,67905,0.005193445,Wednesday
19-09-19,-1770,166135,66135,-0.010541675,Thursday
20-09-19,9932.5,176067.5,76067.5,0.059785716,Friday
23-09-19,620,176687.5,76687.5,0.003521377,Monday
24-09-19,2002.5,178690,78690,0.011333569,Tuesday
25-09-19,992.5,179682.5,79682.5,0.005554312,Wednesday
26-09-19,1882.5,181565,81565,0.010476813,Thursday
27-09-19,1127.5,182692.5,82692.5,0.006209897,Friday
30-09-19,-452.5,182240,82240,-0.002476839,Monday
01-10-19,1280,183520,83520,0.007023705,Tuesday
03-10-19,2777.5,186297.5,86297.5,0.01513459,Thursday
04-10-19,4257.5,190555,90555,0.022853232,Friday
07-10-19,1175,191730,91730,0.006166199,Monday
09-10-19,-1262.5,190467.5,90467.5,-0.006584781,Wednesday
10-10-19,1742.5,192210,92210,0.009148542,Thursday
11-10-19,-2782.5,189427.5,89427.5,-0.014476354,Friday
14-10-19,-350,189077.5,89077.5,-0.001847673,Monday
15-10-19,912.5,189990,89990,0.004826063,Tuesday
16-10-19,-1472.5,188517.5,88517.5,-0.007750408,Wednesday
17-10-19,5227.5,193745,93745,0.027729521,Thursday
18-10-19,120,193865,93865,0.000619371,Friday
22-10-19,1022.5,194887.5,94887.5,0.005274289,Tuesday
23-10-19,1045,195932.5,95932.5,0.005362068,Wednesday
24-10-19,-1930,194002.5,94002.5,-0.009850331,Thursday
25-10-19,-1715,192287.5,92287.5,-0.008840092,Friday
29-10-19,-2960,189327.5,89327.5,-0.015393616,Tuesday
30-10-19,670,189997.5,89997.5,0.003538841,Wednesday
31-10-19,1815,191812.5,91812.5,0.009552757,Thursday
01-11-19,990,192802.5,92802.5,0.00516129,Friday
04-11-19,507.5,193310,93310,0.002632227,Monday
05-11-19,-230,193080,93080,-0.001189799,Tuesday
06-11-19,-2747.5,190332.5,90332.5,-0.014229853,Wednesday
07-11-19,1955,192287.5,92287.5,0.010271499,Thursday
08-11-19,-2537.5,189750,89750,-0.013196386,Friday
11-11-19,407.5,190157.5,90157.5,0.002147563,Monday
13-11-19,687.5,190845,90845,0.003615424,Wednesday
14-11-19,-1020,189825,89825,-0.005344651,Thursday
15-11-19,-47.5,189777.5,89777.5,-0.00025023,Friday
18-11-19,687.5,190465,90465,0.003622663,Monday
19-11-19,492.5,190957.5,90957.5,0.002585777,Tuesday
20-11-19,842.5,191800,91800,0.004411976,Wednesday
21-11-19,657.5,192457.5,92457.5,0.00342805,Thursday
22-11-19,510,192967.5,92967.5,0.002649936,Friday
25-11-19,1545,194512.5,94512.5,0.00800653,Monday
26-11-19,940,195452.5,95452.5,0.004832594,Tuesday
27-11-19,962.5,196415,96415,0.00492447,Wednesday
28-11-19,-367.5,196047.5,96047.5,-0.001871038,Thursday
29-11-19,270,196317.5,96317.5,0.001377217,Friday
02-12-19,22.5,196340,96340,0.00011461,Monday
03-12-19,1845,198185,98185,0.009396964,Tuesday
04-12-19,-2730,195455,95455,-0.013775008,Wednesday
05-12-19,1592.5,197047.5,97047.5,0.008147655,Thursday
06-12-19,-437.5,196610,96610,-0.002220277,Friday
09-12-19,695,197305,97305,0.003534917,Monday
10-12-19,1420,198725,98725,0.007196979,Tuesday
11-12-19,-2337.5,196387.5,96387.5,-0.011762486,Wednesday
12-12-19,1325,197712.5,97712.5,0.006746865,Thursday
13-12-19,-1072.5,196640,96640,-0.005424543,Friday
16-12-19,497.5,197137.5,97137.5,0.002530004,Monday
17-12-19,1012.5,198150,98150,0.005136009,Tuesday
18-12-19,455,198605,98605,0.00229624,Wednesday
19-12-19,-872.5,197732.5,97732.5,-0.004393142,Thursday
20-12-19,605,198337.5,98337.5,0.003059689,Friday
23-12-19,-1950,196387.5,96387.5,-0.009831726,Monday
24-12-19,-650,195737.5,95737.5,-0.003309783,Tuesday
26-12-19,-1555,194182.5,94182.5,-0.007944313,Thursday
27-12-19,-270,193912.5,93912.5,-0.001390445,Friday
30-12-19,407.5,194320,94320,0.002101463,Monday
31-12-19,2227.5,196547.5,96547.5,0.011463051,Tuesday
01-01-20,690,197237.5,97237.5,0.003510602,Wednesday
02-01-20,-917.5,196320,96320,-0.004651752,Thursday
03-01-20,447.5,196767.5,96767.5,0.002279442,Friday
06-01-20,25,196792.5,96792.5,0.000127054,Monday
07-01-20,-762.5,196030,96030,-0.00387464,Tuesday
08-01-20,1352.5,197382.5,97382.5,0.006899454,Wednesday
09-01-20,-1177.5,196205,96205,-0.005965574,Thursday
10-01-20,225,196430,96430,0.00114676,Friday
13-01-20,1272.5,197702.5,97702.5,0.006478135,Monday
14-01-20,2657.5,200360,100360,0.013441914,Tuesday
15-01-20,-2210,198150,98150,-0.011030146,Wednesday
16-01-20,-27.5,198122.5,98122.5,-0.000138784,Thursday
17-01-20,590,198712.5,98712.5,0.002977956,Friday
20-01-20,4175,202887.5,102887.5,0.021010254,Monday
21-01-20,-35,202852.5,102852.5,-0.000172509,Tuesday
22-01-20,2675,205527.5,105527.5,0.013186922,Wednesday
23-01-20,787.5,206315,106315,0.003831604,Thursday
24-01-20,317.5,206632.5,106632.5,0.001538909,Friday
27-01-20,1355,207987.5,107987.5,0.006557536,Monday
28-01-20,2322.5,210310,110310,0.011166536,Tuesday
29-01-20,872.5,211182.5,111182.5,0.004148638,Wednesday
30-01-20,3152.5,214335,114335,0.014927847,Thursday
31-01-20,6415,220750,120750,0.029929783,Friday
01-02-20,-500,220250,120250,-0.002265006,Saturday
03-02-20,1917.5,222167.5,122167.5,0.008706016,Monday
04-02-20,-77.5,222090,122090,-0.000348836,Tuesday
05-02-20,1050,223140,123140,0.004727813,Wednesday
06-02-20,2037.5,225177.5,125177.5,0.009131039,Thursday
07-02-20,655,225832.5,125832.5,0.002908816,Friday
10-02-20,-970,224862.5,124862.5,-0.004295219,Monday
11-02-20,452.5,225315,125315,0.002012341,Tuesday
12-02-20,397.5,225712.5,125712.5,0.001764197,Wednesday
13-02-20,1127.5,226840,126840,0.004995293,Thursday
14-02-20,657.5,227497.5,127497.5,0.002898519,Friday
17-02-20,2167.5,229665,129665,0.009527577,Monday
18-02-20,65,229730,129730,0.000283021,Tuesday
19-02-20,465,230195,130195,0.002024115,Wednesday
20-02-20,-330,229865,129865,-0.001433567,Thursday
24-02-20,-2037.5,227827.5,127827.5,-0.008863898,Monday
25-02-20,702.5,228530,128530,0.003083473,Tuesday
26-02-20,-590,227940,127940,-0.002581718,Wednesday
27-02-20,1085,229025,129025,0.004760025,Thursday
28-02-20,-147.5,228877.5,128877.5,-0.000644034,Friday
02-03-20,-1162.5,227715,127715,-0.005079136,Monday
03-03-20,520,228235,128235,0.002283556,Tuesday
04-03-20,1050,229285,129285,0.004600521,Wednesday
05-03-20,-780,228505,128505,-0.00340188,Thursday
06-03-20,3882.5,232387.5,132387.5,0.016990875,Friday
09-03-20,410,232797.5,132797.5,0.001764295,Monday
11-03-20,707.5,233505,133505,0.003039122,Wednesday
12-03-20,-560,232945,132945,-0.002398236,Thursday
13-03-20,0,232945,132945,0,Friday
16-03-20,-832.5,232112.5,132112.5,-0.003573805,Monday
17-03-20,13775,245887.5,145887.5,0.059346222,Tuesday
18-03-20,-727.5,245160,145160,-0.00295867,Wednesday
19-03-20,-2932.5,242227.5,142227.5,-0.011961576,Thursday
20-03-20,14690,256917.5,156917.5,0.060645468,Friday
23-03-20,5775,262692.5,162692.5,0.022478033,Monday
24-03-20,-2840,259852.5,159852.5,-0.010811119,Tuesday
25-03-20,9952.5,269805,169805,0.038300574,Wednesday
26-03-20,3687.5,273492.5,173492.5,0.013667278,Thursday
27-03-20,-337.5,273155,173155,-0.001234037,Friday
30-03-20,667.5,273822.5,173822.5,0.002443668,Monday
31-03-20,460,274282.5,174282.5,0.00167992,Tuesday
01-04-20,1060,275342.5,175342.5,0.003864629,Wednesday
03-04-20,2402.5,277745,177745,0.008725496,Friday
07-04-20,-2735,275010,175010,-0.009847162,Tuesday
08-04-20,312.5,275322.5,175322.5,0.001136322,Wednesday
09-04-20,565,275887.5,175887.5,0.002052139,Thursday
13-04-20,292.5,276180,176180,0.001060215,Monday
15-04-20,2592.5,278772.5,178772.5,0.009386994,Wednesday
16-04-20,-362.5,278410,178410,-0.001300343,Thursday
17-04-20,820,279230,179230,0.002945297,Friday
20-04-20,387.5,279617.5,179617.5,0.001387745,Monday
21-04-20,52.5,279670,179670,0.000187756,Tuesday
22-04-20,-925,278745,178745,-0.00330747,Wednesday
23-04-20,3012.5,281757.5,181757.5,0.010807369,Thursday
24-04-20,730,282487.5,182487.5,0.00259088,Friday
27-04-20,-2162.5,280325,180325,-0.007655206,Monday
28-04-20,2147.5,282472.5,182472.5,0.007660751,Tuesday
29-04-20,-357.5,282115,182115,-0.00126561,Wednesday
30-04-20,3805,285920,185920,0.013487408,Thursday
04-05-20,647.5,286567.5,186567.5,0.002264619,Monday
05-05-20,3020,289587.5,189587.5,0.010538529,Tuesday
06-05-20,-122.5,289465,189465,-0.000423015,Wednesday
07-05-20,3135,292600,192600,0.010830325,Thursday
08-05-20,527.5,293127.5,193127.5,0.001802802,Friday
11-05-20,-825,292302.5,192302.5,-0.002814475,Monday
12-05-20,-3100,289202.5,189202.5,-0.010605452,Tuesday
13-05-20,-55,289147.5,189147.5,-0.000190178,Wednesday
14-05-20,2567.5,291715,191715,0.008879551,Thursday
15-05-20,-30,291685,191685,-0.00010284,Friday
18-05-20,380,292065,192065,0.001302775,Monday
19-05-20,662.5,292727.5,192727.5,0.002268331,Tuesday
20-05-20,3535,296262.5,196262.5,0.012076078,Wednesday
21-05-20,2377.5,298640,198640,0.008024978,Thursday
22-05-20,1300,299940,199940,0.004353067,Friday
26-05-20,-1107.5,298832.5,198832.5,-0.003692405,Tuesday
27-05-20,4822.5,303655,203655,0.016137803,Wednesday
28-05-20,-1250,302405,202405,-0.004116514,Thursday
29-05-20,-620,301785,201785,-0.002050231,Friday
01-06-20,690,302475,202475,0.002286396,Monday
02-06-20,4930,307405,207405,0.016298868,Tuesday
03-06-20,-2125,305280,205280,-0.006912705,Wednesday
04-06-20,1765,307045,207045,0.005781578,Thursday
05-06-20,972.5,308017.5,208017.5,0.003167288,Friday
08-06-20,-440,307577.5,207577.5,-0.00142849,Monday
09-06-20,1802.5,309380,209380,0.005860312,Tuesday
10-06-20,75,309455,209455,0.00024242,Wednesday
11-06-20,1135,310590,210590,0.003667738,Thursday
12-06-20,-1387.5,309202.5,209202.5,-0.004467304,Friday
15-06-20,415,309617.5,209617.5,0.001342162,Monday
16-06-20,-4192.5,305425,205425,-0.013540901,Tuesday
17-06-20,1160,306585,206585,0.003797986,Wednesday
18-06-20,8675,315260,215260,0.028295579,Thursday
19-06-20,-457.5,314802.5,214802.5,-0.001451183,Friday
22-06-20,-1642.5,313160,213160,-0.005217557,Monday
23-06-20,5040,318200,218200,0.016094009,Tuesday
24-06-20,-2910,315290,215290,-0.009145192,Wednesday
25-06-20,1400,316690,216690,0.004440356,Thursday
26-06-20,-445,316245,216245,-0.00140516,Friday
29-06-20,-2967.5,313277.5,213277.5,-0.009383548,Monday
30-06-20,-177.5,313100,213100,-0.00056659,Tuesday
01-07-20,2317.5,315417.5,215417.5,0.007401789,Wednesday
02-07-20,2755,318172.5,218172.5,0.008734455,Thursday
03-07-20,1100,319272.5,219272.5,0.003457244,Friday
06-07-20,175,319447.5,219447.5,0.000548121,Monday
07-07-20,2292.5,321740,221740,0.007176453,Tuesday
08-07-20,90,321830,221830,0.000279729,Wednesday
09-07-20,1147.5,322977.5,222977.5,0.003565547,Thursday
10-07-20,-1247.5,321730,221730,-0.003862498,Friday
13-07-20,-970,320760,220760,-0.00301495,Monday
14-07-20,-65,320695,220695,-0.000202644,Tuesday
15-07-20,-827.5,319867.5,219867.5,-0.002580333,Wednesday
16-07-20,-1120,318747.5,218747.5,-0.00350145,Thursday
17-07-20,5202.5,323950,223950,0.016321697,Friday
20-07-20,1610,325560,225560,0.004969903,Monday
21-07-20,532.5,326092.5,226092.5,0.001635643,Tuesday
22-07-20,700,326792.5,226792.5,0.00214663,Wednesday
23-07-20,1040,327832.5,227832.5,0.003182448,Thursday
24-07-20,657.5,328490,228490,0.002005597,Friday
27-07-20,-3077.5,325412.5,225412.5,-0.009368626,Monday
28-07-20,2455,327867.5,227867.5,0.007544271,Tuesday
29-07-20,440,328307.5,228307.5,0.001342006,Wednesday
30-07-20,1560,329867.5,229867.5,0.004751643,Thursday
31-07-20,-67.5,329800,229800,-0.000204628,Friday
03-08-20,75,329875,229875,0.000227411,Monday
04-08-20,-907.5,328967.5,228967.5,-0.002751042,Tuesday
05-08-20,-330,328637.5,228637.5,-0.001003139,Wednesday
06-08-20,537.5,329175,229175,0.001635541,Thursday
07-08-20,2660,331835,231835,0.008080808,Friday
10-08-20,790,332625,232625,0.002380701,Monday
11-08-20,-20,332605,232605,-6.01E-05,Tuesday
12-08-20,690,333295,233295,0.002074533,Wednesday
13-08-20,322.5,333617.5,233617.5,0.000967611,Thursday
14-08-20,-1992.5,331625,231625,-0.005972409,Friday
17-08-20,355,331980,231980,0.001070486,Monday
18-08-20,352.5,332332.5,232332.5,0.001061811,Tuesday
19-08-20,-657.5,331675,231675,-0.00197844,Wednesday
20-08-20,765,332440,232440,0.002306475,Thursday
21-08-20,745,333185,233185,0.002241006,Friday
24-08-20,-187.5,332997.5,232997.5,-0.00056275,Monday
25-08-20,710,333707.5,233707.5,0.002132148,Tuesday
26-08-20,2117.5,335825,235825,0.006345377,Wednesday
27-08-20,352.5,336177.5,236177.5,0.001049654,Thursday
28-08-20,2420,338597.5,238597.5,0.007198578,Friday
31-08-20,-3400,335197.5,235197.5,-0.010041421,Monday
01-09-20,1350,336547.5,236547.5,0.004027476,Tuesday
02-09-20,1232.5,337780,237780,0.003662187,Wednesday
03-09-20,1482.5,339262.5,239262.5,0.004388951,Thursday
04-09-20,3935,343197.5,243197.5,0.011598688,Friday
07-09-20,-190,343007.5,243007.5,-0.000553617,Monday
08-09-20,-615,342392.5,242392.5,-0.001792964,Tuesday
09-09-20,825,343217.5,243217.5,0.002409515,Wednesday
10-09-20,-2860,340357.5,240357.5,-0.008332908,Thursday
11-09-20,1177.5,341535,241535,0.003459598,Friday
14-09-20,2732.5,344267.5,244267.5,0.008000644,Monday
15-09-20,1447.5,345715,245715,0.004204579,Tuesday
16-09-20,3495,349210,249210,0.010109483,Wednesday
17-09-20,1512.5,350722.5,250722.5,0.004331205,Thursday
18-09-20,-1800,348922.5,248922.5,-0.005132263,Friday
21-09-20,2442.5,351365,251365,0.007000122,Monday
22-09-20,1902.5,353267.5,253267.5,0.005414597,Tuesday
23-09-20,545,353812.5,253812.5,0.00154274,Wednesday
24-09-20,-1997.5,351815,251815,-0.005645646,Thursday
25-09-20,-617.5,351197.5,251197.5,-0.001755184,Friday
28-09-20,-40,351157.5,251157.5,-0.000113896,Monday
29-09-20,-1230,349927.5,249927.5,-0.003502702,Tuesday
30-09-20,-442.5,349485,249485,-0.001264548,Wednesday
01-10-20,-717.5,348767.5,248767.5,-0.002053021,Thursday
05-10-20,717.5,349485,249485,0.002057244,Monday
06-10-20,2010,351495,251495,0.00575132,Tuesday
07-10-20,770,352265,252265,0.002190643,Wednesday
08-10-20,1822.5,354087.5,254087.5,0.005173662,Thursday
09-10-20,277.5,354365,254365,0.000783705,Friday
12-10-20,-205,354160,254160,-0.0005785,Monday
13-10-20,-1972.5,352187.5,252187.5,-0.005569517,Tuesday
14-10-20,2080,354267.5,254267.5,0.005905945,Wednesday
15-10-20,570,354837.5,254837.5,0.001608954,Thursday
16-10-20,435,355272.5,255272.5,0.001225913,Friday
19-10-20,370,355642.5,255642.5,0.001041454,Monday
20-10-20,977.5,356620,256620,0.002748547,Tuesday
21-10-20,2795,359415,259415,0.007837474,Wednesday
22-10-20,2942.5,362357.5,262357.5,0.008186915,Thursday
23-10-20,832.5,363190,263190,0.002297455,Friday
26-10-20,-67.5,363122.5,263122.5,-0.000185853,Monday
27-10-20,977.5,364100,264100,0.002691929,Tuesday
28-10-20,-1575,362525,262525,-0.004325735,Wednesday
29-10-20,-1727.5,360797.5,260797.5,-0.004765189,Thursday
30-10-20,-2672.5,358125,258125,-0.007407202,Friday
02-11-20,-3352.5,354772.5,254772.5,-0.009361257,Monday
03-11-20,392.5,355165,255165,0.001106343,Tuesday
04-11-20,-2642.5,352522.5,252522.5,-0.007440204,Wednesday
05-11-20,-247.5,352275,252275,-0.000702083,Thursday
06-11-20,-1120,351155,251155,-0.003179334,Friday
09-11-20,1172.5,352327.5,252327.5,0.003338981,Monday
10-11-20,-740,351587.5,251587.5,-0.002100319,Tuesday
11-11-20,2327.5,353915,253915,0.006619974,Wednesday
12-11-20,1427.5,355342.5,255342.5,0.004033454,Thursday
13-11-20,-220,355122.5,255122.5,-0.000619121,Friday
17-11-20,1100,356222.5,256222.5,0.003097523,Tuesday
18-11-20,2315,358537.5,258537.5,0.006498747,Wednesday
19-11-20,5025,363562.5,263562.5,0.01401527,Thursday
20-11-20,955,364517.5,264517.5,0.002626784,Friday
23-11-20,-100,364417.5,264417.5,-0.000274335,Monday
24-11-20,370,364787.5,264787.5,0.001015319,Tuesday
25-11-20,-2852.5,361935,261935,-0.007819621,Wednesday
26-11-20,-2692.5,359242.5,259242.5,-0.007439181,Thursday
27-11-20,-1557.5,357685,257685,-0.004335512,Friday
01-12-20,3252.5,360937.5,260937.5,0.009093197,Tuesday
02-12-20,942.5,361880,261880,0.002611255,Wednesday
03-12-20,2502.5,364382.5,264382.5,0.006915276,Thursday
04-12-20,1807.5,366190,266190,0.004960447,Friday
07-12-20,360,366550,266550,0.000983096,Monday
08-12-20,-17.5,366532.5,266532.5,-4.77E-05,Tuesday
09-12-20,-287.5,366245,266245,-0.000784378,Wednesday
10-12-20,-397.5,365847.5,265847.5,-0.001085339,Thursday
11-12-20,-447.5,365400,265400,-0.001223187,Friday
14-12-20,1490,366890,266890,0.004077723,Monday
15-12-20,2545,369435,269435,0.006936684,Tuesday
16-12-20,1657.5,371092.5,271092.5,0.004486581,Wednesday
17-12-20,600,371692.5,271692.5,0.001616848,Thursday
18-12-20,987.5,372680,272680,0.002656766,Friday
21-12-20,-2165,370515,270515,-0.005809273,Monday
22-12-20,-1435,369080,269080,-0.003872988,Tuesday
23-12-20,-217.5,368862.5,268862.5,-0.000589303,Wednesday
24-12-20,925,369787.5,269787.5,0.00250771,Thursday
28-12-20,802.5,370590,270590,0.002170165,Monday
29-12-20,367.5,370957.5,270957.5,0.000991662,Tuesday
30-12-20,1070,372027.5,272027.5,0.002884427,Wednesday
31-12-20,2297.5,374325,274325,0.006175619,Thursday
01-01-21,955,375280,275280,0.002551259,Friday
04-01-21,662.5,375942.5,275942.5,0.001765349,Monday
05-01-21,3737.5,379680,279680,0.00994168,Tuesday
06-01-21,-2632.5,377047.5,277047.5,-0.00693347,Wednesday
07-01-21,-32.5,377015,277015,-8.62E-05,Thursday
08-01-21,3865,380880,280880,0.010251582,Friday
11-01-21,400,381280,281280,0.0010502,Monday
12-01-21,5247.5,386527.5,286527.5,0.013762851,Tuesday
13-01-21,820,387347.5,287347.5,0.002121453,Wednesday
14-01-21,-1070,386277.5,286277.5,-0.002762377,Thursday
15-01-21,-2910,383367.5,283367.5,-0.007533444,Friday
18-01-21,895,384262.5,284262.5,0.002334575,Monday
19-01-21,-1427.5,382835,282835,-0.003714908,Tuesday
20-01-21,3017.5,385852.5,285852.5,0.007881986,Wednesday
21-01-21,-1922.5,383930,283930,-0.004982474,Thursday
22-01-21,-1875,382055,282055,-0.004883703,Friday
25-01-21,-2472.5,379582.5,279582.5,-0.006471581,Monday
27-01-21,-400,379182.5,279182.5,-0.001053789,Wednesday
28-01-21,2192.5,381375,281375,0.005782176,Thursday
29-01-21,5100,386475,286475,0.013372665,Friday
01-02-21,5562.5,392037.5,292037.5,0.01439291,Monday
02-02-21,910,392947.5,292947.5,0.002321207,Tuesday
03-02-21,4347.5,397295,297295,0.011063819,Wednesday
04-02-21,-2862.5,394432.5,294432.5,-0.007204974,Thursday
05-02-21,855,395287.5,295287.5,0.002167671,Friday
08-02-21,737.5,396025,296025,0.001865731,Monday
09-02-21,312.5,396337.5,296337.5,0.000789092,Tuesday
10-02-21,885,397222.5,297222.5,0.002232945,Wednesday
11-02-21,1925,399147.5,299147.5,0.00484615,Thursday
12-02-21,685,399832.5,299832.5,0.001716158,Friday
15-02-21,2.5,399835,299835,6.25E-06,Monday
16-02-21,-2772.5,397062.5,297062.5,-0.00693411,Tuesday
17-02-21,-1562.5,395500,295500,-0.003935149,Wednesday
18-02-21,1472.5,396972.5,296972.5,0.003723135,Thursday
19-02-21,3305,400277.5,300277.5,0.008325514,Friday
22-02-21,-1565,398712.5,298712.5,-0.003909788,Monday
23-02-21,432.5,399145,299145,0.001084742,Tuesday
24-02-21,-152.5,398992.5,298992.5,-0.000382067,Wednesday
25-02-21,-2250,396742.5,296742.5,-0.005639204,Thursday
26-02-21,-1205,395537.5,295537.5,-0.003037234,Friday
01-03-21,875,396412.5,296412.5,0.00221218,Monday
02-03-21,267.5,396680,296680,0.000674802,Tuesday
03-03-21,-2772.5,393907.5,293907.5,-0.006989261,Wednesday
04-03-21,-310,393597.5,293597.5,-0.000786987,Thursday
05-03-21,-145,393452.5,293452.5,-0.000368397,Friday
08-03-21,1165,394617.5,294617.5,0.002960967,Monday
09-03-21,2215,396832.5,296832.5,0.00561303,Tuesday
10-03-21,2855,399687.5,299687.5,0.007194471,Wednesday
12-03-21,-3037.5,396650,296650,-0.007599687,Friday
15-03-21,1290,397940,297940,0.003252237,Monday
16-03-21,340,398280,298280,0.0008544,Tuesday
17-03-21,4100,402380,302380,0.010294265,Wednesday
18-03-21,4942.5,407322.5,307322.5,0.012283165,Thursday
19-03-21,-2972.5,404350,304350,-0.007297657,Friday
22-03-21,955,405305,305305,0.002361815,Monday
23-03-21,1315,406620,306620,0.00324447,Tuesday
24-03-21,-1087.5,405532.5,305532.5,-0.002674487,Wednesday
25-03-21,-837.5,404695,304695,-0.002065186,Thursday
26-03-21,1352.5,406047.5,306047.5,0.003342023,Friday
30-03-21,-882.5,405165,305165,-0.002173391,Tuesday
31-03-21,327.5,405492.5,305492.5,0.000808313,Wednesday
01-04-21,1432.5,406925,306925,0.003532741,Thursday
05-04-21,7392.5,414317.5,314317.5,0.018166738,Monday
06-04-21,1065,415382.5,315382.5,0.002570492,Tuesday
07-04-21,942.5,416325,316325,0.002268993,Wednesday
08-04-21,-1632.5,414692.5,314692.5,-0.003921215,Thursday
09-04-21,-2442.5,412250,312250,-0.005889906,Friday
12-04-21,-70,412180,312180,-0.0001698,Monday
13-04-21,2380,414560,314560,0.005774176,Tuesday
15-04-21,-1762.5,412797.5,312797.5,-0.004251496,Thursday
16-04-21,-2685,410112.5,310112.5,-0.0065044,Friday
19-04-21,-717.5,409395,309395,-0.00174952,Monday
20-04-21,-3025,406370,306370,-0.007388952,Tuesday
22-04-21,-1410,404960,304960,-0.003469744,Thursday
23-04-21,545,405505,305505,0.001345812,Friday
26-04-21,797.5,406302.5,306302.5,0.001966684,Monday
27-04-21,-317.5,405985,305985,-0.000781437,Tuesday
28-04-21,-547.5,405437.5,305437.5,-0.001348572,Wednesday
29-04-21,-1555,403882.5,303882.5,-0.003835363,Thursday
30-04-21,5137.5,409020,309020,0.012720284,Friday
03-05-21,-172.5,408847.5,308847.5,-0.00042174,Monday
04-05-21,575,409422.5,309422.5,0.001406392,Tuesday
05-05-21,310,409732.5,309732.5,0.000757164,Wednesday
06-05-21,2960,412692.5,312692.5,0.007224226,Thursday
07-05-21,767.5,413460,313460,0.001859738,Friday
10-05-21,602.5,414062.5,314062.5,0.001457215,Monday
11-05-21,287.5,414350,314350,0.00069434,Tuesday
12-05-21,1110,415460,315460,0.002678895,Wednesday
14-05-21,1860,417320,317320,0.004476965,Friday
17-05-21,6412.5,423732.5,323732.5,0.015365906,Monday
18-05-21,200,423932.5,323932.5,0.000471996,Tuesday
19-05-21,1260,425192.5,325192.5,0.002972171,Wednesday
20-05-21,1457.5,426650,326650,0.003427859,Thursday
21-05-21,1965,428615,328615,0.004605649,Friday
24-05-21,-1672.5,426942.5,326942.5,-0.003902103,Monday
25-05-21,-2582.5,424360,324360,-0.006048824,Tuesday
26-05-21,-165,424195,324195,-0.000388821,Wednesday
27-05-21,-1647.5,422547.5,322547.5,-0.003883827,Thursday
28-05-21,360,422907.5,322907.5,0.000851975,Friday
31-05-21,4825,427732.5,327732.5,0.011409114,Monday
01-06-21,480,428212.5,328212.5,0.001122197,Tuesday
02-06-21,-325,427887.5,327887.5,-0.000758969,Wednesday
03-06-21,1377.5,429265,329265,0.003219304,Thursday
04-06-21,1352.5,430617.5,330617.5,0.003150734,Friday
07-06-21,1360,431977.5,331977.5,0.003158255,Monday
08-06-21,350,432327.5,332327.5,0.000810227,Tuesday
09-06-21,-140,432187.5,332187.5,-0.000323829,Wednesday
10-06-21,957.5,433145,333145,0.002215474,Thursday
11-06-21,1010,434155,334155,0.002331783,Friday
14-06-21,-2012.5,432142.5,332142.5,-0.004635441,Monday
15-06-21,-665,431477.5,331477.5,-0.001538844,Tuesday
16-06-21,165,431642.5,331642.5,0.000382407,Wednesday
17-06-21,70,431712.5,331712.5,0.000162171,Thursday
18-06-21,5327.5,437040,337040,0.012340389,Friday
21-06-21,645,437685,337685,0.001475837,Monday
22-06-21,-935,436750,336750,-0.00213624,Tuesday
23-06-21,-592.5,436157.5,336157.5,-0.001356611,Wednesday
24-06-21,905,437062.5,337062.5,0.002074939,Thursday
25-06-21,1880,438942.5,338942.5,0.004301444,Friday
28-06-21,162.5,439105,339105,0.000370208,Monday
29-06-21,687.5,439792.5,339792.5,0.001565685,Tuesday
30-06-21,465,440257.5,340257.5,0.001057317,Wednesday
01-07-21,1040,441297.5,341297.5,0.002362254,Thursday
02-07-21,522.5,441820,341820,0.001184009,Friday
05-07-21,1250,443070,343070,0.002829206,Monday
06-07-21,150,443220,343220,0.000338547,Tuesday
07-07-21,-495,442725,342725,-0.001116827,Wednesday
08-07-21,2372.5,445097.5,345097.5,0.005358857,Thursday
09-07-21,882.5,445980,345980,0.001982712,Friday
12-07-21,-3090,442890,342890,-0.006928562,Monday
13-07-21,1015,443905,343905,0.002291765,Tuesday
14-07-21,3807.5,447712.5,347712.5,0.008577286,Wednesday
15-07-21,1115,448827.5,348827.5,0.002490438,Thursday
16-07-21,542.5,449370,349370,0.001208705,Friday
19-07-21,-610,448760,348760,-0.001357456,Monday
20-07-21,1200,449960,349960,0.002674035,Tuesday
22-07-21,-1060,448900,348900,-0.002355765,Thursday
23-07-21,112.5,449012.5,349012.5,0.000250613,Friday
26-07-21,590,449602.5,349602.5,0.001313995,Monday
27-07-21,2065,451667.5,351667.5,0.004592946,Tuesday
28-07-21,752.5,452420,352420,0.001666049,Wednesday
29-07-21,1327.5,453747.5,353747.5,0.00293422,Thursday
30-07-21,-577.5,453170,353170,-0.001272734,Friday
02-08-21,47.5,453217.5,353217.5,0.000104817,Monday
03-08-21,-3202.5,450015,350015,-0.007066144,Tuesday
04-08-21,957.5,450972.5,350972.5,0.002127707,Wednesday
05-08-21,670,451642.5,351642.5,0.001485678,Thursday
06-08-21,1187.5,452830,352830,0.002629292,Friday
09-08-21,-1627.5,451202.5,351202.5,-0.003594064,Monday
10-08-21,-1305,449897.5,349897.5,-0.002892271,Tuesday
11-08-21,-3285,446612.5,346612.5,-0.007301663,Wednesday
12-08-21,535,447147.5,347147.5,0.001197906,Thursday
13-08-21,-692.5,446455,346455,-0.001548706,Friday
16-08-21,67.5,446522.5,346522.5,0.000151191,Monday
17-08-21,2435,448957.5,348957.5,0.005453253,Tuesday
18-08-21,-2627.5,446330,346330,-0.005852447,Wednesday
20-08-21,880,447210,347210,0.001971635,Friday
23-08-21,240,447450,347450,0.000536661,Monday
24-08-21,2522.5,449972.5,349972.5,0.005637501,Tuesday
25-08-21,602.5,450575,350575,0.001338971,Wednesday
26-08-21,575,451150,351150,0.001276147,Thursday
27-08-21,-225,450925,350925,-0.000498725,Friday
30-08-21,-260,450665,350665,-0.000576593,Monday
31-08-21,-2647.5,448017.5,348017.5,-0.005874652,Tuesday
01-09-21,-485,447532.5,347532.5,-0.001082547,Wednesday
02-09-21,-337.5,447195,347195,-0.000754135,Thursday
03-09-21,-2350,444845,344845,-0.005254978,Friday
06-09-21,457.5,445302.5,345302.5,0.001028448,Monday
07-09-21,-1015,444287.5,344287.5,-0.002279349,Tuesday
08-09-21,-665,443622.5,343622.5,-0.001496779,Wednesday
09-09-21,1990,445612.5,345612.5,0.004485796,Thursday
13-09-21,865,446477.5,346477.5,0.001941148,Monday
14-09-21,827.5,447305,347305,0.001853397,Tuesday
15-09-21,3495,450800,350800,0.007813461,Wednesday
16-09-21,-1552.5,449247.5,349247.5,-0.003443878,Thursday
17-09-21,110,449357.5,349357.5,0.000244854,Friday
20-09-21,55,449412.5,349412.5,0.000122397,Monday
21-09-21,2422.5,451835,351835,0.005390371,Tuesday
22-09-21,-2352.5,449482.5,349482.5,-0.005206547,Wednesday
23-09-21,-2350,447132.5,347132.5,-0.005228235,Thursday
24-09-21,660,447792.5,347792.5,0.001476073,Friday
27-09-21,-2690,445102.5,345102.5,-0.006007247,Monday
28-09-21,6560,451662.5,351662.5,0.014738178,Tuesday
29-09-21,622.5,452285,352285,0.001378241,Wednesday
30-09-21,-2467.5,449817.5,349817.5,-0.005455631,Thursday
01-10-21,-2647.5,447170,347170,-0.00588572,Friday
04-10-21,417.5,447587.5,347587.5,0.000933649,Monday
05-10-21,3677.5,451265,351265,0.008216271,Tuesday
06-10-21,-2802.5,448462.5,348462.5,-0.00621032,Wednesday
07-10-21,2505,450967.5,350967.5,0.005585751,Thursday
08-10-21,-835,450132.5,350132.5,-0.001851575,Friday
11-10-21,505,450637.5,350637.5,0.001121892,Monday
12-10-21,392.5,451030,351030,0.000870988,Tuesday
13-10-21,-70,450960,350960,-0.0001552,Wednesday
14-10-21,-1447.5,449512.5,349512.5,-0.003209819,Thursday
18-10-21,760,450272.5,350272.5,0.001690721,Monday
19-10-21,-2095,448177.5,348177.5,-0.004652738,Tuesday
20-10-21,1812.5,449990,349990,0.004044157,Wednesday
21-10-21,-475,449515,349515,-0.001055579,Thursday
22-10-21,-2532.5,446982.5,346982.5,-0.00563385,Friday
25-10-21,607.5,447590,347590,0.001359114,Monday
26-10-21,2360,449950,349950,0.005272683,Tuesday
27-10-21,675,450625,350625,0.001500167,Wednesday
28-10-21,-1427.5,449197.5,349197.5,-0.003167822,Thursday
29-10-21,-1395,447802.5,347802.5,-0.003105538,Friday
01-11-21,-960,446842.5,346842.5,-0.002143802,Monday
02-11-21,1402.5,448245,348245,0.00313869,Tuesday
03-11-21,-672.5,447572.5,347572.5,-0.001500296,Wednesday
08-11-21,-2502.5,445070,345070,-0.005591273,Monday
09-11-21,722.5,445792.5,345792.5,0.00162334,Tuesday
10-11-21,-110,445682.5,345682.5,-0.000246752,Wednesday
11-11-21,1990,447672.5,347672.5,0.004465062,Thursday
12-11-21,1240,448912.5,348912.5,0.002769882,Friday
15-11-21,217.5,449130,349130,0.000484504,Monday
16-11-21,1047.5,450177.5,350177.5,0.002332287,Tuesday
17-11-21,1252.5,451430,351430,0.002782236,Wednesday
18-11-21,-830,450600,350600,-0.001838602,Thursday
22-11-21,-2730,447870,347870,-0.006058589,Monday
23-11-21,10,447880,347880,2.23E-05,Tuesday
24-11-21,-387.5,447492.5,347492.5,-0.000865187,Wednesday
25-11-21,-1555,445937.5,345937.5,-0.003474919,Thursday
26-11-21,-3087.5,442850,342850,-0.006923616,Friday
29-11-21,557.5,443407.5,343407.5,0.001258891,Monday
30-11-21,-3122.5,440285,340285,-0.007042055,Tuesday
01-12-21,1007.5,441292.5,341292.5,0.002288291,Wednesday
02-12-21,-1525,439767.5,339767.5,-0.003455758,Thursday
03-12-21,-55,439712.5,339712.5,-0.000125066,Friday
06-12-21,8547.5,448260,348260,0.019438838,Monday
07-12-21,30,448290,348290,6.69E-05,Tuesday
08-12-21,1762.5,450052.5,350052.5,0.003931607,Wednesday
09-12-21,220,450272.5,350272.5,0.000488832,Thursday
10-12-21,382.5,450655,350655,0.000849486,Friday
13-12-21,-2602.5,448052.5,348052.5,-0.005774928,Monday
14-12-21,505,448557.5,348557.5,0.0011271,Tuesday
15-12-21,-1612.5,446945,346945,-0.003594857,Wednesday
16-12-21,-2420,444525,344525,-0.005414536,Thursday
17-12-21,-702.5,443822.5,343822.5,-0.001580339,Friday
20-12-21,1370,445192.5,345192.5,0.00308682,Monday
21-12-21,395,445587.5,345587.5,0.000887257,Tuesday
22-12-21,2390,447977.5,347977.5,0.005363705,Wednesday
23-12-21,2345,450322.5,350322.5,0.005234638,Thursday
24-12-21,857.5,451180,351180,0.001904191,Friday
27-12-21,-60,451120,351120,-0.000132985,Monday
28-12-21,587.5,451707.5,351707.5,0.001302314,Tuesday
29-12-21,895,452602.5,352602.5,0.001981371,Wednesday
30-12-21,2752.5,455355,355355,0.006081495,Thursday
31-12-21,335,455690,355690,0.00073569,Friday
03-01-22,0,455690,355690,0,Monday
04-01-22,0,455690,355690,0,Tuesday
05-01-22,0,455690,355690,0,Wednesday
06-01-22,1247.5,456937.5,356937.5,0.002737607,Thursday
07-01-22,0,456937.5,356937.5,0,Friday
10-01-22,0,456937.5,356937.5,0,Monday
11-01-22,0,456937.5,356937.5,0,Tuesday
12-01-22,0,456937.5,356937.5,0,Wednesday
13-01-22,3690,460627.5,360627.5,0.008075503,Thursday
14-01-22,0,460627.5,360627.5,0,Friday
17-01-22,0,460627.5,360627.5,0,Monday
18-01-22,0,460627.5,360627.5,0,Tuesday
19-01-22,0,460627.5,360627.5,0,Wednesday
20-01-22,-1865,458762.5,358762.5,-0.004048825,Thursday
21-01-22,0,458762.5,358762.5,0,Friday
24-01-22,0,458762.5,358762.5,0,Monday
25-01-22,0,458762.5,358762.5,0,Tuesday
27-01-22,2590,461352.5,361352.5,0.005645623,Thursday
28-01-22,0,461352.5,361352.5,0,Friday
31-01-22,0,461352.5,361352.5,0,Monday
01-02-22,0,461352.5,361352.5,0,Tuesday
02-02-22,0,461352.5,361352.5,0,Wednesday
03-02-22,887.5,462240,362240,0.001923692,Thursday
04-02-22,0,462240,362240,0,Friday
07-02-22,0,462240,362240,0,Monday
08-02-22,0,462240,362240,0,Tuesday
09-02-22,0,462240,362240,0,Wednesday
10-02-22,-1382.5,460857.5,360857.5,-0.002990871,Thursday
11-02-22,187.5,461045,361045,0.00040685,Friday
14-02-22,2332.5,463377.5,363377.5,0.005059159,Monday
15-02-22,-2620,460757.5,360757.5,-0.005654137,Tuesday
16-02-22,945,461702.5,361702.5,0.00205097,Wednesday
17-02-22,3787.5,465490,365490,0.008203334,Thursday
18-02-22,0,465490,365490,0,Friday
21-02-22,0,465490,365490,0,Monday
22-02-22,0,465490,365490,0,Tuesday
23-02-22,0,465490,365490,0,Wednesday
24-02-22,-730,464760,364760,-0.00156824,Thursday
25-02-22,-817.5,463942.5,363942.5,-0.001758972,Friday
28-02-22,-2960,460982.5,360982.5,-0.006380101,Monday
02-03-22,1870,462852.5,362852.5,0.004056553,Wednesday
03-03-22,1917.5,464770,364770,0.004142788,Thursday
04-03-22,400,465170,365170,0.000860641,Friday
07-03-22,282.5,465452.5,365452.5,0.000607305,Monday
08-03-22,442.5,465895,365895,0.000950688,Tuesday
09-03-22,-357.5,465537.5,365537.5,-0.00076734,Wednesday
10-03-22,1435,466972.5,366972.5,0.003082458,Thursday
11-03-22,-2320,464652.5,364652.5,-0.004968173,Friday
14-03-22,-1490,463162.5,363162.5,-0.003206697,Monday
15-03-22,2955,466117.5,366117.5,0.00638005,Tuesday
16-03-22,-525,465592.5,365592.5,-0.001126325,Wednesday
17-03-22,-232.5,465360,365360,-0.000499364,Thursday
21-03-22,60,465420,365420,0.000128932,Monday
22-03-22,905,466325,366325,0.00194448,Tuesday
23-03-22,242.5,466567.5,366567.5,0.000520024,Wednesday
24-03-22,2227.5,468795,368795,0.004774229,Thursday
25-03-22,0,468795,368795,0,Friday
28-03-22,0,468795,368795,0,Monday
29-03-22,0,468795,368795,0,Tuesday
30-03-22,0,468795,368795,0,Wednesday
31-03-22,-1502.5,467292.5,367292.5,-0.003205026,Thursday
01-04-22,5467.5,472760,372760,0.01170038,Friday
04-04-22,227.5,472987.5,372987.5,0.000481217,Monday
05-04-22,512.5,473500,373500,0.001083538,Tuesday
06-04-22,1825,475325,375325,0.003854277,Wednesday
07-04-22,-27.5,475297.5,375297.5,-5.79E-05,Thursday
08-04-22,-570,474727.5,374727.5,-0.001199249,Friday
11-04-22,2805,477532.5,377532.5,0.005908653,Monday
12-04-22,1212.5,478745,378745,0.002539094,Tuesday
13-04-22,-1777.5,476967.5,376967.5,-0.003712833,Wednesday
18-04-22,702.5,477670,377670,0.001472847,Monday
19-04-22,-1652.5,476017.5,376017.5,-0.003459501,Tuesday
20-04-22,172.5,476190,376190,0.000362382,Wednesday
21-04-22,-1950,474240,374240,-0.004095004,Thursday
22-04-22,4700,478940,378940,0.009910594,Friday
25-04-22,20,478960,378960,4.18E-05,Monday
26-04-22,-1932.5,477027.5,377027.5,-0.004034784,Tuesday
27-04-22,755,477782.5,377782.5,0.001582718,Wednesday
28-04-22,6545,484327.5,384327.5,0.013698702,Thursday
29-04-22,-452.5,483875,383875,-0.000934285,Friday
02-05-22,-2442.5,481432.5,381432.5,-0.005047791,Monday
04-05-22,10805,492237.5,392237.5,0.022443437,Wednesday
05-05-22,2265,494502.5,394502.5,0.004601437,Thursday
06-05-22,-1415,493087.5,393087.5,-0.002861462,Friday
09-05-22,187.5,493275,393275,0.000380257,Monday
10-05-22,1780,495055,395055,0.003608535,Tuesday
11-05-22,1020,496075,396075,0.002060377,Wednesday
12-05-22,-710,495365,395365,-0.001431235,Thursday
13-05-22,-1225,494140,394140,-0.002472924,Friday
16-05-22,477.5,494617.5,394617.5,0.000966325,Monday
17-05-22,5150,499767.5,399767.5,0.010412086,Tuesday
18-05-22,-157.5,499610,399610,-0.000315147,Wednesday
19-05-22,-1322.5,498287.5,398287.5,-0.002647065,Thursday
20-05-22,2460,500747.5,400747.5,0.004936909,Friday
23-05-22,677.5,501425,401425,0.001352977,Monday
24-05-22,802.5,502227.5,402227.5,0.001600439,Tuesday
25-05-22,195,502422.5,402422.5,0.00038827,Wednesday
26-05-22,3300,505722.5,405722.5,0.006568177,Thursday
27-05-22,3257.5,508980,408980,0.00644128,Friday
30-05-22,862.5,509842.5,409842.5,0.001694566,Monday
31-05-22,-612.5,509230,409230,-0.001201351,Tuesday
01-06-22,6717.5,515947.5,415947.5,0.013191485,Wednesday
02-06-22,240,516187.5,416187.5,0.000465164,Thursday
03-06-22,192.5,516380,416380,0.000372927,Friday
06-06-22,85,516465,416465,0.000164607,Monday
07-06-22,370,516835,416835,0.000716409,Tuesday
08-06-22,287.5,517122.5,417122.5,0.00055627,Wednesday
09-06-22,-1565,515557.5,415557.5,-0.003026362,Thursday
10-06-22,10,515567.5,415567.5,1.94E-05,Friday
13-06-22,175,515742.5,415742.5,0.000339432,Monday
14-06-22,572.5,516315,416315,0.00111005,Tuesday
15-06-22,-1747.5,514567.5,414567.5,-0.003384562,Wednesday
16-06-22,-1317.5,513250,413250,-0.002560403,Thursday
17-06-22,-290,512960,412960,-0.000565027,Friday
20-06-22,-2237.5,510722.5,410722.5,-0.004361939,Monday
21-06-22,-1072.5,509650,409650,-0.002099966,Tuesday
22-06-22,565,510215,410215,0.001108604,Wednesday
23-06-22,1752.5,511967.5,411967.5,0.003434826,Thursday
24-06-22,0,511967.5,411967.5,0,Friday
27-06-22,0,511967.5,411967.5,0,Monday
28-06-22,0,511967.5,411967.5,0,Tuesday
29-06-22,0,511967.5,411967.5,0,Wednesday
30-06-22,-317.5,511650,411650,-0.000620157,Thursday
01-07-22,-182.5,511467.5,411467.5,-0.000356689,Friday
04-07-22,3190,514657.5,414657.5,0.006236955,Monday
05-07-22,-205,514452.5,414452.5,-0.000398323,Tuesday
06-07-22,-1710,512742.5,412742.5,-0.003323922,Wednesday
07-07-22,-1185,511557.5,411557.5,-0.002311102,Thursday
08-07-22,662.5,512220,412220,0.001295065,Friday
11-07-22,-2297.5,509922.5,409922.5,-0.004485377,Monday
12-07-22,37.5,509960,409960,7.35E-05,Tuesday
13-07-22,3435,513395,413395,0.006735822,Wednesday
14-07-22,-1485,511910,411910,-0.00289251,Thursday
15-07-22,4620,516530,416530,0.009025024,Friday
18-07-22,-655,515875,415875,-0.001268077,Monday
19-07-22,-177.5,515697.5,415697.5,-0.000344076,Tuesday
20-07-22,502.5,516200,416200,0.000974408,Wednesday
21-07-22,-1417.5,514782.5,414782.5,-0.002746029,Thursday
22-07-22,-425,514357.5,414357.5,-0.000825591,Friday
25-07-22,617.5,514975,414975,0.001200527,Monday
26-07-22,2612.5,517587.5,417587.5,0.005073062,Tuesday
27-07-22,4652.5,522240,422240,0.008988818,Wednesday
28-07-22,-1597.5,520642.5,420642.5,-0.003058938,Thursday
29-07-22,2030,522672.5,422672.5,0.003899029,Friday
01-08-22,-230,522442.5,422442.5,-0.000440046,Monday
02-08-22,1770,524212.5,424212.5,0.003387933,Tuesday
03-08-22,-232.5,523980,423980,-0.000443522,Wednesday
04-08-22,2485,526465,426465,0.004742547,Thursday
05-08-22,-677.5,525787.5,425787.5,-0.001286885,Friday
08-08-22,-27.5,525760,425760,-5.23E-05,Monday
10-08-22,1405,527165,427165,0.002672322,Wednesday
11-08-22,1282.5,528447.5,428447.5,0.002432825,Thursday
12-08-22,2210,530657.5,430657.5,0.004182062,Friday
16-08-22,1202.5,531860,431860,0.002266057,Tuesday
17-08-22,-365,531495,431495,-0.000686271,Wednesday
18-08-22,3197.5,534692.5,434692.5,0.006016049,Thursday
19-08-22,4857.5,539550,439550,0.009084661,Friday
22-08-22,355,539905,439905,0.000657956,Monday
23-08-22,-1337.5,538567.5,438567.5,-0.002477288,Tuesday
24-08-22,-1870,536697.5,436697.5,-0.003472174,Wednesday
25-08-22,-1925,534772.5,434772.5,-0.00358675,Thursday
26-08-22,290,535062.5,435062.5,0.000542287,Friday
29-08-22,360,535422.5,435422.5,0.000672819,Monday
30-08-22,-2990,532432.5,432432.5,-0.005584375,Tuesday
01-09-22,1070,533502.5,433502.5,0.002009644,Thursday
02-09-22,-715,532787.5,432787.5,-0.0013402,Friday
05-09-22,345,533132.5,433132.5,0.000647538,Monday
06-09-22,-517.5,532615,432615,-0.000970678,Tuesday
07-09-22,182.5,532797.5,432797.5,0.000342649,Wednesday
08-09-22,3400,536197.5,436197.5,0.006381411,Thursday
09-09-22,117.5,536315,436315,0.000219136,Friday
12-09-22,170,536485,436485,0.000316978,Monday
13-09-22,192.5,536677.5,436677.5,0.000358817,Tuesday
14-09-22,-927.5,535750,435750,-0.001728226,Wednesday
15-09-22,-492.5,535257.5,435257.5,-0.000919272,Thursday
16-09-22,-1227.5,534030,434030,-0.002293289,Friday
19-09-22,195,534225,434225,0.000365148,Monday
20-09-22,422.5,534647.5,434647.5,0.000790865,Tuesday
21-09-22,-240,534407.5,434407.5,-0.000448894,Wednesday
22-09-22,235,534642.5,434642.5,0.000439739,Thursday
23-09-22,0,534642.5,434642.5,0,Friday
26-09-22,0,534642.5,434642.5,0,Monday
27-09-22,0,534642.5,434642.5,0,Tuesday
28-09-22,0,534642.5,434642.5,0,Wednesday
29-09-22,787.5,535430,435430,0.001472947,Thursday
30-09-22,8150,543580,443580,0.015221411,Friday
03-10-22,1280,544860,444860,0.002354759,Monday
04-10-22,40,544900,444900,7.34E-05,Tuesday
06-10-22,-1612.5,543287.5,443287.5,-0.002959259,Thursday
07-10-22,-7.5,543280,443280,-1.38E-05,Friday
10-10-22,-1642.5,541637.5,441637.5,-0.003023303,Monday
11-10-22,62.5,541700,441700,0.000115391,Tuesday
12-10-22,-325,541375,441375,-0.000599963,Wednesday
13-10-22,832.5,542207.5,442207.5,0.001537751,Thursday
14-10-22,415,542622.5,442622.5,0.00076539,Friday
17-10-22,-202.5,542420,442420,-0.000373188,Monday
18-10-22,512.5,542932.5,442932.5,0.00094484,Tuesday
19-10-22,400,543332.5,443332.5,0.00073674,Wednesday
20-10-22,1315,544647.5,444647.5,0.002420249,Thursday
21-10-22,-1140,543507.5,443507.5,-0.002093097,Friday
25-10-22,-910,542597.5,442597.5,-0.00167431,Tuesday
27-10-22,2137.5,544735,444735,0.003939384,Thursday
28-10-22,400,545135,445135,0.000734302,Friday
31-10-22,-590,544545,444545,-0.001082301,Monday
01-11-22,927.5,545472.5,445472.5,0.001703257,Tuesday
02-11-22,200,545672.5,445672.5,0.000366655,Wednesday
03-11-22,3087.5,548760,448760,0.005658156,Thursday
04-11-22,-2352.5,546407.5,446407.5,-0.004286938,Friday
07-11-22,-2027.5,544380,444380,-0.003710601,Monday
09-11-22,810,545190,445190,0.001487931,Wednesday
10-11-22,1702.5,546892.5,446892.5,0.003122765,Thursday
11-11-22,150,547042.5,447042.5,0.000274277,Friday
14-11-22,-1457.5,545585,445585,-0.002664327,Monday
15-11-22,1860,547445,447445,0.003409185,Tuesday
16-11-22,-2707.5,544737.5,444737.5,-0.004945702,Wednesday
17-11-22,500,545237.5,445237.5,0.000917873,Thursday
18-11-22,705,545942.5,445942.5,0.001293015,Friday
21-11-22,347.5,546290,446290,0.000636514,Monday
22-11-22,572.5,546862.5,446862.5,0.001047978,Tuesday
23-11-22,1642.5,548505,448505,0.003003497,Wednesday
24-11-22,-2642.5,545862.5,445862.5,-0.004817641,Thursday
25-11-22,812.5,546675,446675,0.00148847,Friday
28-11-22,325,547000,447000,0.000594503,Monday
29-11-22,1122.5,548122.5,448122.5,0.002052102,Tuesday
30-11-22,1562.5,549685,449685,0.00285064,Wednesday
01-12-22,710,550395,450395,0.001291649,Thursday
02-12-22,662.5,551057.5,451057.5,0.001203681,Friday
05-12-22,-2092.5,548965,448965,-0.003797244,Monday
06-12-22,-3120,545845,445845,-0.005683422,Tuesday
07-12-22,3187.5,549032.5,449032.5,0.00583957,Wednesday
08-12-22,2542.5,551575,451575,0.004630873,Thursday
09-12-22,1920,553495,453495,0.003480941,Friday
12-12-22,1800,555295,455295,0.003252062,Monday
13-12-22,-1080,554215,454215,-0.001944912,Tuesday
14-12-22,122.5,554337.5,454337.5,0.000221033,Wednesday
15-12-22,-2285,552052.5,452052.5,-0.004122038,Thursday
16-12-22,915,552967.5,452967.5,0.001657451,Friday
19-12-22,-1380,551587.5,451587.5,-0.002495626,Monday
20-12-22,-2185,549402.5,449402.5,-0.003961294,Tuesday
21-12-22,2675,552077.5,452077.5,0.004868926,Wednesday
22-12-22,157.5,552235,452235,0.000285286,Thursday
23-12-22,0,552235,452235,0,Friday
26-12-22,0,552235,452235,0,Monday
27-12-22,1395,553630,453630,0.002526098,Tuesday
28-12-22,0,553630,453630,0,Wednesday
29-12-22,-1687.5,551942.5,451942.5,-0.003048065,Thursday
30-12-22,0,551942.5,451942.5,0,Friday
02-01-23,387.5,552330,452330,0.000702066,Monday
03-01-23,-3135,549195,449195,-0.005675955,Tuesday
04-01-23,1847.5,551042.5,451042.5,0.003364015,Wednesday
05-01-23,712.5,551755,451755,0.001293004,Thursday
06-01-23,910,552665,452665,0.001649283,Friday
09-01-23,1120,553785,453785,0.002026544,Monday
10-01-23,-77.5,553707.5,453707.5,-0.000139946,Tuesday
11-01-23,952.5,554660,454660,0.001720222,Wednesday
12-01-23,-680,553980,453980,-0.001225976,Thursday
13-01-23,-1287.5,552692.5,452692.5,-0.002324091,Friday
16-01-23,675,553367.5,453367.5,0.001221294,Monday
17-01-23,910,554277.5,454277.5,0.001644477,Tuesday
18-01-23,475,554752.5,454752.5,0.000856971,Wednesday
19-01-23,2570,557322.5,457322.5,0.004632697,Thursday
20-01-23,3602.5,560925,460925,0.006463941,Friday
23-01-23,-1915,559010,459010,-0.003414004,Monday
24-01-23,-1677.5,557332.5,457332.5,-0.003000841,Tuesday
25-01-23,-2925,554407.5,454407.5,-0.005248214,Wednesday
27-01-23,527.5,554935,454935,0.000951466,Friday
30-01-23,-1537.5,553397.5,453397.5,-0.002770595,Monday
31-01-23,-12.5,553385,453385,-2.26E-05,Tuesday
01-02-23,-1430,551955,451955,-0.002584096,Wednesday
02-02-23,3437.5,555392.5,455392.5,0.006227863,Thursday
03-02-23,4907.5,560300,460300,0.008836093,Friday
06-02-23,267.5,560567.5,460567.5,0.000477423,Monday
07-02-23,-295,560272.5,460272.5,-0.000526252,Tuesday
08-02-23,485,560757.5,460757.5,0.00086565,Wednesday
09-02-23,-2512.5,558245,458245,-0.004480546,Thursday
10-02-23,552.5,558797.5,458797.5,0.000989709,Friday
13-02-23,1962.5,560760,460760,0.003512006,Monday
14-02-23,1945,562705,462705,0.003468507,Tuesday
15-02-23,1027.5,563732.5,463732.5,0.001826001,Wednesday
16-02-23,-152.5,563580,463580,-0.000270518,Thursday
17-02-23,-177.5,563402.5,463402.5,-0.000314951,Friday
20-02-23,1380,564782.5,464782.5,0.002449403,Monday
21-02-23,-2525,562257.5,462257.5,-0.004470748,Tuesday
22-02-23,-1270,560987.5,460987.5,-0.002258752,Wednesday
23-02-23,650,561637.5,461637.5,0.001158671,Thursday
24-02-23,357.5,561995,461995,0.000636532,Friday
27-02-23,940,562935,462935,0.001672613,Monday
28-02-23,-2.5,562932.5,462932.5,-4.44E-06,Tuesday
01-03-23,1825,564757.5,464757.5,0.003241952,Wednesday
02-03-23,77.5,564835,464835,0.000137227,Thursday
03-03-23,-2985,561850,461850,-0.005284729,Friday
06-03-23,542.5,562392.5,462392.5,0.00096556,Monday
08-03-23,-660,561732.5,461732.5,-0.001173558,Wednesday
09-03-23,-2760,558972.5,458972.5,-0.004913371,Thursday
10-03-23,40,559012.5,459012.5,7.16E-05,Friday
13-03-23,6562.5,565575,465575,0.011739451,Monday
14-03-23,472.5,566047.5,466047.5,0.000835433,Tuesday
15-03-23,895,566942.5,466942.5,0.001581139,Wednesday
16-03-23,-1530,565412.5,465412.5,-0.002698686,Thursday
17-03-23,282.5,565695,465695,0.000499635,Friday
20-03-23,-2832.5,562862.5,462862.5,-0.005007115,Monday
21-03-23,800,563662.5,463662.5,0.001421306,Tuesday
22-03-23,90,563752.5,463752.5,0.00015967,Wednesday
23-03-23,-2907.5,560845,460845,-0.005157405,Thursday
24-03-23,2467.5,563312.5,463312.5,0.004399611,Friday
27-03-23,1297.5,564610,464610,0.00230334,Monday
28-03-23,1225,565835,465835,0.002169639,Tuesday
29-03-23,557.5,566392.5,466392.5,0.00098527,Wednesday
31-03-23,-1162.5,565230,465230,-0.002052464,Friday
03-04-23,1185,566415,466415,0.002096492,Monday
05-04-23,-357.5,566057.5,466057.5,-0.000631163,Wednesday
06-04-23,812.5,566870,466870,0.001435367,Thursday
10-04-23,785,567655,467655,0.001384797,Monday
11-04-23,515,568170,468170,0.000907241,Tuesday
12-04-23,1572.5,569742.5,469742.5,0.002767658,Wednesday
13-04-23,1672.5,571415,471415,0.002935537,Thursday
17-04-23,-1560,569855,469855,-0.002730065,Monday
18-04-23,730,570585,470585,0.001281028,Tuesday
19-04-23,367.5,570952.5,470952.5,0.000644076,Wednesday
20-04-23,-820,570132.5,470132.5,-0.001436197,Thursday
21-04-23,-1727.5,568405,468405,-0.003029997,Friday
24-04-23,1095,569500,469500,0.001926443,Monday
25-04-23,355,569855,469855,0.000623354,Tuesday
26-04-23,-1302.5,568552.5,468552.5,-0.002285669,Wednesday
27-04-23,-455,568097.5,468097.5,-0.000800278,Thursday
28-04-23,-1950,566147.5,466147.5,-0.003432509,Friday
02-05-23,-1615,564532.5,464532.5,-0.002852613,Tuesday
03-05-23,-2800,561732.5,461732.5,-0.004959856,Wednesday
04-05-23,5510,567242.5,467242.5,0.009808939,Thursday
05-05-23,-1320,565922.5,465922.5,-0.002327047,Friday
08-05-23,-317.5,565605,465605,-0.000561031,Monday
09-05-23,-815,564790,464790,-0.001440935,Tuesday
10-05-23,-107.5,564682.5,464682.5,-0.000190336,Wednesday
11-05-23,2477.5,567160,467160,0.004387421,Thursday
12-05-23,-2100,565060,465060,-0.003702659,Friday
15-05-23,425,565485,465485,0.000752133,Monday
16-05-23,-390,565095,465095,-0.000689673,Tuesday
17-05-23,2512.5,567607.5,467607.5,0.004446155,Wednesday
18-05-23,-2880,564727.5,464727.5,-0.005073929,Thursday
19-05-23,-605,564122.5,464122.5,-0.001071313,Friday
22-05-23,-695,563427.5,463427.5,-0.001232002,Monday
23-05-23,445,563872.5,463872.5,0.000789809,Tuesday
24-05-23,-327.5,563545,463545,-0.000580805,Wednesday
25-05-23,-1387.5,562157.5,462157.5,-0.002462093,Thursday
26-05-23,3265,565422.5,465422.5,0.005807981,Friday
29-05-23,575,565997.5,465997.5,0.001016939,Monday
30-05-23,852.5,566850,466850,0.00150619,Tuesday
31-05-23,602.5,567452.5,467452.5,0.001062891,Wednesday
01-06-23,-7.5,567445,467445,-1.32E-05,Thursday
02-06-23,872.5,568317.5,468317.5,0.001537594,Friday
05-06-23,702.5,569020,469020,0.001236105,Monday
06-06-23,1007.5,570027.5,470027.5,0.001770588,Tuesday
07-06-23,-762.5,569265,469265,-0.001337655,Wednesday
08-06-23,-2247.5,567017.5,467017.5,-0.003948073,Thursday
09-06-23,-952.5,566065,466065,-0.001679842,Friday
12-06-23,365,566430,466430,0.000644802,Monday
13-06-23,260,566690,466690,0.000459015,Tuesday
14-06-23,2147.5,568837.5,468837.5,0.00378955,Wednesday
15-06-23,-1205,567632.5,467632.5,-0.002118355,Thursday
16-06-23,692.5,568325,468325,0.001219979,Friday
19-06-23,465,568790,468790,0.000818194,Monday
20-06-23,-1362.5,567427.5,467427.5,-0.002395436,Tuesday
21-06-23,-2742.5,564685,464685,-0.004833217,Wednesday
22-06-23,-2120,562565,462565,-0.003754305,Thursday
23-06-23,0,562565,462565,0,Friday
26-06-23,0,562565,462565,0,Monday
27-06-23,0,562565,462565,0,Tuesday
28-06-23,-3045,559520,459520,-0.005412708,Wednesday
30-06-23,-697.5,558822.5,458822.5,-0.001246604,Friday
03-07-23,862.5,559685,459685,0.001543424,Monday
04-07-23,-805,558880,458880,-0.001438309,Tuesday
05-07-23,-2115,556765,456765,-0.003784354,Wednesday
06-07-23,1680,558445,458445,0.003017431,Thursday
07-07-23,-3095,555350,455350,-0.005542175,Friday
10-07-23,670,556020,456020,0.001206446,Monday
11-07-23,842.5,556862.5,456862.5,0.001515233,Tuesday
12-07-23,277.5,557140,457140,0.000498328,Wednesday
13-07-23,0,557140,457140,0,Thursday
14-07-23,0,557140,457140,0,Friday
17-07-23,-1590,555550,455550,-0.002853861,Monday
18-07-23,572.5,556122.5,456122.5,0.00103051,Tuesday
19-07-23,870,556992.5,456992.5,0.001564404,Wednesday
20-07-23,8390,565382.5,465382.5,0.015063039,Thursday
21-07-23,-2397.5,562985,462985,-0.004240492,Friday
24-07-23,872.5,563857.5,463857.5,0.001549775,Monday
25-07-23,710,564567.5,464567.5,0.001259183,Tuesday
26-07-23,-3250,561317.5,461317.5,-0.005756619,Wednesday
27-07-23,-3790,557527.5,457527.5,-0.006751972,Thursday
28-07-23,330,557857.5,457857.5,0.000591899,Friday
31-07-23,-195,557662.5,457662.5,-0.000349552,Monday
01-08-23,520,558182.5,458182.5,0.000932464,Tuesday
02-08-23,3962.5,562145,462145,0.007098933,Wednesday
03-08-23,4677.5,566822.5,466822.5,0.008320807,Thursday
04-08-23,307.5,567130,467130,0.000542498,Friday
07-08-23,207.5,567337.5,467337.5,0.000365877,Monday
08-08-23,560,567897.5,467897.5,0.000987067,Tuesday
09-08-23,527.5,568425,468425,0.000928865,Wednesday
10-08-23,492.5,568917.5,468917.5,0.000866429,Thursday
11-08-23,707.5,569625,469625,0.00124359,Friday
14-08-23,-1562.5,568062.5,468062.5,-0.002743033,Monday
16-08-23,485,568547.5,468547.5,0.000853779,Wednesday
17-08-23,-957.5,567590,467590,-0.001684116,Thursday
18-08-23,552.5,568142.5,468142.5,0.000973414,Friday
21-08-23,1770,569912.5,469912.5,0.003115416,Monday
22-08-23,-132.5,569780,469780,-0.000232492,Tuesday
23-08-23,1095,570875,470875,0.001921794,Wednesday
24-08-23,-2352.5,568522.5,468522.5,-0.004120867,Thursday
25-08-23,22.5,568545,468545,3.96E-05,Friday
28-08-23,855,569400,469400,0.001503839,Monday
29-08-23,692.5,570092.5,470092.5,0.001216192,Tuesday
30-08-23,-1500,568592.5,468592.5,-0.002631152,Wednesday
31-08-23,-1040,567552.5,467552.5,-0.001829078,Thursday
01-09-23,-1700,565852.5,465852.5,-0.002995318,Friday
04-09-23,-385,565467.5,465467.5,-0.000680389,Monday
05-09-23,547.5,566015,466015,0.000968225,Tuesday
06-09-23,-2417.5,563597.5,463597.5,-0.004271088,Wednesday
07-09-23,7960,571557.5,471557.5,0.014123554,Thursday
08-09-23,-15,571542.5,471542.5,-2.62E-05,Friday
11-09-23,-425,571117.5,471117.5,-0.000743602,Monday
12-09-23,727.5,571845,471845,0.001273818,Tuesday
13-09-23,22.5,571867.5,471867.5,3.93E-05,Wednesday
14-09-23,685,572552.5,472552.5,0.00119783,Thursday
15-09-23,1422.5,573975,473975,0.002484488,Friday
18-09-23,590,574565,474565,0.001027919,Monday
20-09-23,130,574695,474695,0.000226258,Wednesday
21-09-23,217.5,574912.5,474912.5,0.000378462,Thursday
22-09-23,1212.5,576125,476125,0.002109017,Friday
25-09-23,-182.5,575942.5,475942.5,-0.000316772,Monday
26-09-23,632.5,576575,476575,0.0010982,Tuesday
27-09-23,-1087.5,575487.5,475487.5,-0.001886138,Wednesday
28-09-23,-2912.5,572575,472575,-0.005060927,Thursday
29-09-23,875,573450,473450,0.001528184,Friday
03-10-23,-2757.5,570692.5,470692.5,-0.004808615,Tuesday
04-10-23,362.5,571055,471055,0.000635193,Wednesday
05-10-23,725,571780,471780,0.00126958,Thursday
06-10-23,167.5,571947.5,471947.5,0.000292945,Friday
09-10-23,110,572057.5,472057.5,0.000192325,Monday
10-10-23,-95,571962.5,471962.5,-0.000166067,Tuesday
11-10-23,360,572322.5,472322.5,0.000629412,Wednesday
12-10-23,2132.5,574455,474455,0.003726046,Thursday
13-10-23,62.5,574517.5,474517.5,0.000108799,Friday
16-10-23,-205,574312.5,474312.5,-0.000356821,Monday
17-10-23,-2802.5,571510,471510,-0.004879748,Tuesday
18-10-23,2157.5,573667.5,473667.5,0.003775087,Wednesday
19-10-23,-1412.5,572255,472255,-0.002462228,Thursday
20-10-23,187.5,572442.5,472442.5,0.000327651,Friday
23-10-23,8780,581222.5,481222.5,0.015337785,Monday
25-10-23,-1340,579882.5,479882.5,-0.002305485,Wednesday
26-10-23,-1232.5,578650,478650,-0.002125431,Thursday
27-10-23,457.5,579107.5,479107.5,0.000790633,Friday
30-10-23,-2967.5,576140,476140,-0.005124264,Monday
31-10-23,197.5,576337.5,476337.5,0.000342799,Tuesday
01-11-23,247.5,576585,476585,0.000429436,Wednesday
02-11-23,1645,578230,478230,0.002853005,Thursday
03-11-23,577.5,578807.5,478807.5,0.000998738,Friday
06-11-23,1830,580637.5,480637.5,0.003161673,Monday
07-11-23,245,580882.5,480882.5,0.00042195,Tuesday
08-11-23,167.5,581050,481050,0.000288354,Wednesday
09-11-23,990,582040,482040,0.001703812,Thursday
10-11-23,-412.5,581627.5,481627.5,-0.000708714,Friday
13-11-23,410,582037.5,482037.5,0.000704919,Monday
15-11-23,1275,583312.5,483312.5,0.002190581,Wednesday
16-11-23,320,583632.5,483632.5,0.000548591,Thursday
17-11-23,75,583707.5,483707.5,0.000128506,Friday
20-11-23,-2445,581262.5,481262.5,-0.004188742,Monday
21-11-23,585,581847.5,481847.5,0.00100643,Tuesday
22-11-23,820,582667.5,482667.5,0.001409304,Wednesday
23-11-23,-100,582567.5,482567.5,-0.000171624,Thursday
24-11-23,565,583132.5,483132.5,0.000969845,Friday
28-11-23,1350,584482.5,484482.5,0.002315083,Tuesday
29-11-23,-1947.5,582535,482535,-0.003332007,Wednesday
30-11-23,730,583265,483265,0.001253144,Thursday
01-12-23,-265,583000,483000,-0.000454339,Friday
04-12-23,2182.5,585182.5,485182.5,0.003743568,Monday
05-12-23,1482.5,586665,486665,0.002533398,Tuesday
06-12-23,-290,586375,486375,-0.00049432,Wednesday
07-12-23,2500,588875,488875,0.004263483,Thursday
08-12-23,-1482.5,587392.5,487392.5,-0.002517512,Friday
11-12-23,-1527.5,585865,485865,-0.002600476,Monday
12-12-23,-627.5,585237.5,485237.5,-0.001071066,Tuesday
13-12-23,1015,586252.5,486252.5,0.001734339,Wednesday
14-12-23,1615,587867.5,487867.5,0.002754786,Thursday
15-12-23,-2705,585162.5,485162.5,-0.004601377,Friday
18-12-23,490,585652.5,485652.5,0.000837374,Monday
19-12-23,-2922.5,582730,482730,-0.004990161,Tuesday
20-12-23,-2185,580545,480545,-0.003749592,Wednesday
21-12-23,-1530,579015,479015,-0.002635455,Thursday
22-12-23,-295,578720,478720,-0.000509486,Friday
26-12-23,2397.5,581117.5,481117.5,0.004142763,Tuesday
27-12-23,-1102.5,580015,480015,-0.001897207,Wednesday
28-12-23,2322.5,582337.5,482337.5,0.004004207,Thursday
29-12-23,-1580,580757.5,480757.5,-0.002713203,Friday
01-01-24,5262.5,586020,486020,0.009061441,Monday
02-01-24,435,586455,486455,0.000742295,Tuesday
03-01-24,52.5,586507.5,486507.5,8.95E-05,Wednesday
04-01-24,262.5,586770,486770,0.000447565,Thursday
05-01-24,22.5,586792.5,486792.5,3.83E-05,Friday
08-01-24,5587.5,592380,492380,0.009522105,Monday
09-01-24,-1465,590915,490915,-0.002473075,Tuesday
10-01-24,-297.5,590617.5,490617.5,-0.000503457,Wednesday
11-01-24,-50,590567.5,490567.5,-8.47E-05,Thursday
12-01-24,-3160,587407.5,487407.5,-0.005350785,Friday
15-01-24,-210,587197.5,487197.5,-0.000357503,Monday
16-01-24,1072.5,588270,488270,0.001826472,Tuesday
17-01-24,-1452.5,586817.5,486817.5,-0.002469104,Wednesday
18-01-24,-1062.5,585755,485755,-0.001810614,Thursday
19-01-24,2207.5,587962.5,487962.5,0.00376864,Friday
20-01-24,0,587962.5,487962.5,0,Saturday
23-01-24,9327.5,597290,497290,0.015864107,Tuesday
24-01-24,5800,603090,503090,0.009710526,Wednesday
25-01-24,-805,602285,502285,-0.001334792,Thursday
29-01-24,-272.5,602012.5,502012.5,-0.000452444,Monday
30-01-24,747.5,602760,502760,0.001241669,Tuesday
31-01-24,-1787.5,600972.5,500972.5,-0.002965525,Wednesday
01-02-24,1625,602597.5,502597.5,0.002703951,Thursday
02-02-24,410,603007.5,503007.5,0.000680388,Friday
05-02-24,407.5,603415,503415,0.000675779,Monday
06-02-24,3117.5,606532.5,506532.5,0.005166428,Tuesday
07-02-24,747.5,607280,507280,0.001232415,Wednesday
08-02-24,10067.5,617347.5,517347.5,0.01657802,Thursday
09-02-24,842.5,618190,518190,0.00136471,Friday
12-02-24,245,618435,518435,0.000396318,Monday
13-02-24,3207.5,621642.5,521642.5,0.005186479,Tuesday
14-02-24,-2387.5,619255,519255,-0.003840632,Wednesday
15-02-24,450,619705,519705,0.00072668,Thursday
16-02-24,252.5,619957.5,519957.5,0.000407452,Friday
19-02-24,175,620132.5,520132.5,0.000282277,Monday
20-02-24,-1900,618232.5,518232.5,-0.003063861,Tuesday
21-02-24,-1170,617062.5,517062.5,-0.001892492,Wednesday
22-02-24,2907.5,619970,519970,0.00471184,Thursday
23-02-24,-1707.5,618262.5,518262.5,-0.002754166,Friday
26-02-24,97.5,618360,518360,0.0001577,Monday
27-02-24,800,619160,519160,0.001293745,Tuesday
28-02-24,7222.5,626382.5,526382.5,0.011664998,Wednesday
29-02-24,1805,628187.5,528187.5,0.002881626,Thursday
01-03-24,-1022.5,627165,527165,-0.001627699,Friday
04-03-24,182.5,627347.5,527347.5,0.000290992,Monday
05-03-24,2090,629437.5,529437.5,0.003331487,Tuesday
06-03-24,1307.5,630745,530745,0.002077252,Wednesday
07-03-24,2522.5,633267.5,533267.5,0.003999239,Thursday
11-03-24,1307.5,634575,534575,0.002064688,Monday
12-03-24,695,635270,535270,0.001095221,Tuesday
13-03-24,3000,638270,538270,0.004722401,Wednesday
14-03-24,-1482.5,636787.5,536787.5,-0.002322685,Thursday
15-03-24,2710,639497.5,539497.5,0.004255737,Friday
18-03-24,-980,638517.5,538517.5,-0.001532453,Monday
19-03-24,997.5,639515,539515,0.001562212,Tuesday
20-03-24,-657.5,638857.5,538857.5,-0.001028123,Wednesday
21-03-24,2237.5,641095,541095,0.003502346,Thursday
22-03-24,4142.5,645237.5,545237.5,0.006461601,Friday
26-03-24,372.5,645610,545610,0.000577307,Tuesday
27-03-24,2975,648585,548585,0.004608045,Wednesday
28-03-24,1987.5,650572.5,550572.5,0.003064363,Thursday
01-04-24,2022.5,652595,552595,0.0031088,Monday
02-04-24,-337.5,652257.5,552257.5,-0.000517166,Tuesday
03-04-24,5580,657837.5,557837.5,0.008554904,Wednesday
04-04-24,-847.5,656990,556990,-0.001288312,Thursday
05-04-24,1662.5,658652.5,558652.5,0.00253048,Friday
08-04-24,215,658867.5,558867.5,0.000326424,Monday
09-04-24,1507.5,660375,560375,0.002288017,Tuesday
10-04-24,3975,664350,564350,0.006019307,Wednesday
12-04-24,267.5,664617.5,564617.5,0.000402649,Friday
15-04-24,3157.5,667775,567775,0.004750853,Monday
16-04-24,842.5,668617.5,568617.5,0.001261653,Tuesday
18-04-24,-6122.5,662495,562495,-0.009156954,Thursday
19-04-24,-3057.5,659437.5,559437.5,-0.004615129,Friday
22-04-24,1822.5,661260,561260,0.002763719,Monday
23-04-24,-505,660755,560755,-0.000763694,Tuesday
24-04-24,765,661520,561520,0.001157766,Wednesday
25-04-24,-725,660795,560795,-0.001095961,Thursday
26-04-24,250,661045,561045,0.000378332,Friday
29-04-24,1725,662770,562770,0.002609505,Monday
30-04-24,0,662770,562770,0,Tuesday
02-05-24,0,662770,562770,0,Thursday
03-05-24,0,662770,562770,0,Friday
06-05-24,0,662770,562770,0,Monday
07-05-24,0,662770,562770,0,Tuesday
08-05-24,0,662770,562770,0,Wednesday
09-05-24,0,662770,562770,0,Thursday
10-05-24,0,662770,562770,0,Friday
13-05-24,0,662770,562770,0,Monday
14-05-24,0,662770,562770,0,Tuesday
15-05-24,0,662770,562770,0,Wednesday
16-05-24,0,662770,562770,0,Thursday
17-05-24,0,662770,562770,0,Friday
